1 star Star Restaurants:
Le Prince Noir - Vivien Durand - fr - Vivien Durand - 1 star
La Distillerie - lu - lu - 1 star
Äponem - Auberge du Presbytère - fr - Auberge du Presbytère - 1 star
Grič - si - si - 1 star
De Kas - nl - Noord - nl - 1 star
Thierry Schwartz - Le Restaurant - fr - Le Restaurant - 1 star
La Table d'Hôtes - La Rôtisserie du Chambertin - fr - Burgundy - Franche - La Rôtisserie du Chambertin - 1 star
Toya - fr - fr - 1 star
Salt - hu - hu - 1 star
Alte Schule - Klassenzimmer - de - Mecklenburg - Klassenzimmer - 1 star
Bellefeuille - Saint James Paris - fr - Ile - de - Saint James Paris - 1 star
Fiotto - kr - kr - 1 star
Brutø - us - us - 1 star
Regina Montium - ch - ch - 1 star
OD Urla - tr - tr - 1 star
Soil - gr - gr - 1 star
Korak - hr - hr - 1 star
Lutum - nl - nl - 1 star
LATURE - jp - jp - 1 star
TIAN - at - at - 1 star

3 star Star Restaurants:
noma - dk - dk - 3 star
Troisgros - Le Bois sans Feuilles - fr - Auvergne - Rhône - Le Bois sans Feuilles - 3 star
Rutz - de - de - 3 star
Maaemo - no - no - 3 star
Hiša Franko - si - si - 3 star
Kashiwaya Osaka Senriyama - jp - jp - 3 star
De Librije - nl - nl - 3 star
L'Enclume - gb - gb - 3 star
El Celler de Can Roca - es - es - 3 star
L'Effervescence - jp - jp - 3 star
Piazza Duomo - it - it - 3 star
Taian Table - cn - cn - 3 star
Mirazur - fr - Provence - Alpes - fr - 3 star
Osteria Francescana - it - Emilia - it - 3 star
Schloss Schauenstein - ch - ch - 3 star
The Inn at Little Washington - us - us - 3 star
Atelier Moessmer Norbert Niederkofler - it - Trentino - it - 3 star
Sven Wassmer Memories - ch - ch - 3 star
Atelier Crenn - us - us - 3 star
Arpège - fr - Ile - de - fr - 3 star

2 star Star Restaurants:
Château de Beaulieu - Christophe Dufossé - fr - Christophe Dufossé - 2 star
etz - de - de - 2 star
Vespertine - us - us - 2 star
Il Gallo d'Oro - pt - pt - 2 star
Delta - gr - gr - 2 star
King's Joy - cn - cn - 2 star
La Peca - it - it - 2 star
Flore - nl - Noord - nl - 2 star
La Côte Saint - Jacques - fr - Burgundy - Franche - Jacques - 2 star
Amber - hk - hk - 2 star
Tuju - br - br - 2 star
Christophe Hay - Fleur de Loire - fr - Centre - Fleur de Loire - 2 star
Kontrast - no - no - 2 star
Restaurant Sat Bains - gb - gb - 2 star
Table - Bruno Verjus - fr - Ile - de - Bruno Verjus - 2 star
Den - jp - jp - 2 star
L'air du temps - be - be - 2 star
Essigbrätlein - de - de - 2 star
Maison Aribert - fr - Auvergne - Rhône - fr - 2 star
Alchemist - dk - dk - 2 star

